Photo for Sead KolasinacSead Kolasinac	Defender	 Bosnia And Herzegovina
Photo for David OspinaDavid Ospina	Goalkeeper	 Colombia
Photo for Petr CechPetr Cech	Goalkeeper	 Czech Republic
Photo for Mathieu DebuchyMathieu Debuchy	Defender	 France
Photo for Per MertesackerPer Mertesacker	Defender	 Germany
Photo for Laurent KoscielnyLaurent Koscielny	Defender	 France
Photo for Rob HoldingRob Holding	Defender	 England
Photo for Nacho MonrealNacho Monreal	Defender	 Spain
Photo for Shkodran MustafiShkodran Mustafi	Defender	 Germany
Photo for Calum ChambersCalum Chambers	Defender	 England
Photo for Héctor BellerínHéctor Bellerín	Defender	 Spain
Photo for Aaron RamseyAaron Ramsey	Midfielder	 Wales
Photo for Jack WilshereJack Wilshere	Midfielder	 England
Photo for Mesut ÖzilMesut Özil	Midfielder	 Germany
Photo for Alex IwobiAlex Iwobi	Midfielder	 Nigeria
Photo for Santiago CazorlaSantiago Cazorla	Midfielder	 Spain
Photo for Granit XhakaGranit Xhaka	Midfielder	 Switzerland
Photo for Francis CoquelinFrancis Coquelin	Midfielder	 France
Photo for Mohamed ElnenyMohamed Elneny	Midfielder	 Egypt
Photo for Ainsley Maitland-NilesAinsley Maitland-Niles	Midfielder	 England
Photo for Alexis SánchezAlexis Sánchez	Forward	 Chile
Photo for Olivier GiroudOlivier Giroud	Forward	 France
Photo for Theo WalcottTheo Walcott	Forward	 England
Photo for Danny WelbeckDanny Welbeck	Forward	 England
Photo for Alexandre LacazetteAlexandre Lacazette	Forward	 France
Photo for Joe WillockJoe Willock	Midfielder	 England
Photo for Reiss NelsonReiss Nelson	Forward	 England
Photo for Eddie NketiahEddie Nketiah	Forward	 England
Photo for Matt MaceyMatt Macey	Goalkeeper	 England
Photo for Jeff Reine-AdelaideJeff Reine-Adelaide	Midfielder	 France
Photo for Chuba AkpomChuba Akpom	Forward	 England
Photo for Eddie NketiahEddie Nketiah	Forward	 England
Photo for Vlad DragomirVlad Dragomir	Midfielder	 Romania
Photo for Charlie GilmourCharlie Gilmour	Midfielder	 Scotland
Photo for Marcus McGuaneMarcus McGuane	Midfielder	 England
Photo for Josh Da SilvaJosh Da Silva	Forward	 England
Photo for Jordi Osei-TutuJordi Osei-Tutu	Defender	 England
Photo for Ben SheafBen Sheaf	Midfielder	 England
Photo for Dejan IlievDejan Iliev	Goalkeeper	 Macedonia