Photo for Mat RyanMat Ryan	Goalkeeper	 Australia
Photo for Niki MäenpääNiki Mäenpää	Goalkeeper	 Finland
Photo for BrunoBruno	Defender	 Spain
Photo for Gaëtan BongGaëtan Bong	Defender	 Cameroon
Photo for Uwe HünemeierUwe Hünemeier	Defender	 Germany
Photo for Lewis DunkLewis Dunk	Defender	 England
Photo for Connor GoldsonConnor Goldson	Defender	 England
Photo for Shane DuffyShane Duffy	Defender	 Ireland
Photo for Liam RoseniorLiam Rosenior	Defender	 England
Photo for Pascal GroßPascal Groß	Midfielder	 Germany
Photo for Dale StephensDale Stephens	Midfielder	 England
Photo for Beram KayalBeram Kayal	Midfielder	 Israel
Photo for Jiri SkalakJiri Skalak	Midfielder	 Czech Republic
Photo for Anthony KnockaertAnthony Knockaert	Midfielder	 France
Photo for Steve SidwellSteve Sidwell	Midfielder	 England
Photo for Solly MarchSolly March	Midfielder	 England
Photo for Sam BaldockSam Baldock	Forward	 England
Photo for Tomer HemedTomer Hemed	Forward	 Israel
Photo for Jamie MurphyJamie Murphy	Midfielder	 Scotland
Photo for Glenn MurrayGlenn Murray	Forward	 England
Photo for Markus SuttnerMarkus Suttner	Defender	 Austria
Photo for Henrik Rorvik BjørdalHenrik Rorvik Bjørdal	Midfielder	 Norway
Photo for Isaiah BrownIsaiah Brown	Forward	 England
Photo for Davy PröpperDavy Pröpper	Midfielder	 Netherlands
Photo for José IzquierdoJosé Izquierdo	Forward	 Colombia
Photo for Soufyan AhannachSoufyan Ahannach	Midfielder	 Netherlands
Photo for Jayson MolumbyJayson Molumby	Midfielder	 Ireland
Photo for Aaron ConnollyAaron Connolly	Forward	 Ireland
Photo for Ezequiel SchelottoEzequiel Schelotto	Defender	 Italy
Photo for Tim KrulTim Krul	Goalkeeper	 Netherlands
Photo for Tim KrulTim Krul	Goalkeeper	 Netherlands
Photo for Des HutchinsonDes Hutchinson	Midfielder	 Ireland
Photo for James TilleyJames Tilley	Forward	 England