Photo for Nathan AkéNathan Aké	Defender	 Netherlands
Photo for Asmir BegovicAsmir Begovic	Goalkeeper	 Bosnia And Herzegovina
Photo for Jermain DefoeJermain Defoe	Forward	 England
Photo for Artur BorucArtur Boruc	Goalkeeper	 Poland
Photo for Aaron RamsdaleAaron Ramsdale	Goalkeeper	 England
Photo for Simon FrancisSimon Francis	Defender	 England
Photo for Steve CookSteve Cook	Defender	 England
Photo for Charlie DanielsCharlie Daniels	Defender	 England
Photo for Brad SmithBrad Smith	Defender	 Australia
Photo for Adam SmithAdam Smith	Defender	 England
Photo for Tyrone MingsTyrone Mings	Defender	 England
Photo for Dan GoslingDan Gosling	Midfielder	 England
Photo for Andrew SurmanAndrew Surman	Midfielder	 England
Photo for Marc PughMarc Pugh	Midfielder	 England
Photo for Harry ArterHarry Arter	Midfielder	 Ireland
Photo for Lewis CookLewis Cook	Midfielder	 England
Photo for Junior StanislasJunior Stanislas	Midfielder	 England
Photo for Emerson HyndmanEmerson Hyndman	Midfielder	 United States
Photo for Ryan FraserRyan Fraser	Midfielder	 Scotland
Photo for Jordon IbeJordon Ibe	Midfielder	 England
Photo for Benik AfobeBenik Afobe	Forward	 Congo
Photo for Callum WilsonCallum Wilson	Forward	 England
Photo for Joshua KingJoshua King	Forward	 Norway
Photo for Lys MoussetLys Mousset	Forward	 France
Photo for Jack SimpsonJack Simpson	Defender	 England
Photo for Connor MahoneyConnor Mahoney	Midfielder	 England
Photo for Matt ButcherMatt Butcher	Forward	 England
Photo for Adam FedericiAdam Federici	Goalkeeper	 Australia