Photo for Davy KlaassenDavy Klaassen	Midfielder	 Netherlands
Photo for Joel RoblesJoel Robles	Goalkeeper	 Spain
Photo for Maarten StekelenburgMaarten Stekelenburg	Goalkeeper	 Netherlands
Photo for Leighton BainesLeighton Baines	Defender	 England
Photo for Ashley WilliamsAshley Williams	Defender	 Wales
Photo for Phil JagielkaPhil Jagielka	Defender	 England
Photo for Seamus ColemanSeamus Coleman	Defender	 Ireland
Photo for Ramiro Funes MoriRamiro Funes Mori	Defender	 Argentina
Photo for Jonjoe KennyJonjoe Kenny	Defender	 England
Photo for Morgan SchneiderlinMorgan Schneiderlin	Midfielder	 France
Photo for Ross BarkleyRoss Barkley	Midfielder	 England
Photo for Kevin MirallasKevin Mirallas	Midfielder	 Belgium
Photo for James McCarthyJames McCarthy	Midfielder	 Ireland
Photo for Idrissa GueyeIdrissa Gueye	Midfielder	 Senegal
Photo for Muhamed BesicMuhamed Besic	Midfielder	 Bosnia And Herzegovina
Photo for Tom DaviesTom Davies	Midfielder	 England
Photo for Yannick BolasieYannick Bolasie	Forward	 Congo
Photo for Dominic Calvert-LewinDominic Calvert-Lewin	Forward	 England
Photo for Ademola LookmanAdemola Lookman	Forward	 England
Photo for Sandro RamírezSandro Ramírez	Forward	 Spain
Photo for Michael KeaneMichael Keane	Defender	 England
Photo for Wayne RooneyWayne Rooney	Forward	 England
Photo for Cuco MartinaCuco Martina	Defender	 Curacao
Photo for Oumar NiasseOumar Niasse	Forward	 Senegal
Photo for Gylfi SigurdssonGylfi Sigurdsson	Midfielder	 Iceland
Photo for Aaron LennonAaron Lennon	Midfielder	 England
Photo for Nikola VlasicNikola Vlasic	Forward	 Croatia
Photo for Jordan PickfordJordan Pickford	Goalkeeper	 England
Photo for Mason HolgateMason Holgate	Defender	 England
Photo for Beni BaningimeBeni Baningime	Midfielder	 England
Photo for Morgan FeeneyMorgan Feeney	Defender	 England
Photo for Mateusz HeweltMateusz Hewelt	Goalkeeper	 Poland
Photo for Michael CollinsMichael Collins	Defender	 England
Photo for Harry CharsleyHarry Charsley	Midfielder	 Ireland
Photo for Nathan BroadheadNathan Broadhead	Midfielder	 Wales
Photo for Alex DennyAlex Denny	Midfielder	 England
Photo for Fraser HornbyFraser Hornby	Midfielder	 England
Photo for Stephen Duke-McKennaStephen Duke-McKenna	Midfielder	 England
Photo for Anthony GordonAnthony Gordon	Midfielder	 England
Photo for Shayne LaveryShayne Lavery	Forward	 Northern Ireland