Photo for Aaron MooyAaron Mooy	Midfielder	 Australia
Photo for Laurent DepoitreLaurent Depoitre	Forward	 Belgium
Photo for Jonas LösslJonas Lössl	Goalkeeper	 Denmark
Photo for Elias KachungaElias Kachunga	Forward	 Congo
Photo for Joel ColemanJoel Coleman	Goalkeeper	 England
Photo for Tommy SmithTommy Smith	Defender	 England
Photo for Martin CranieMartin Cranie	Defender	 England
Photo for Chris LöweChris Löwe	Defender	 Germany
Photo for Christopher SchindlerChristopher Schindler	Defender	 Germany
Photo for Jon Gorenc StankovicJon Gorenc Stankovic	Defender	 Slovenia
Photo for Michael HefeleMichael Hefele	Defender	 Germany
Photo for Dean WhiteheadDean Whitehead	Midfielder	 England
Photo for Jonathan HoggJonathan Hogg	Midfielder	 England
Photo for Philip BillingPhilip Billing	Midfielder	 Denmark
Photo for Rajiv van La ParraRajiv van La Parra	Midfielder	 Netherlands
Photo for Joe LolleyJoe Lolley	Forward	 England
Photo for Collin QuanerCollin Quaner	Forward	 Germany
Photo for Danny WilliamsDanny Williams	Midfielder	 United States
Photo for Tom InceTom Ince	Midfielder	 England
Photo for Kasey PalmerKasey Palmer	Midfielder	 England
Photo for Steve MounieSteve Mounie	Forward	 Benin
Photo for Scott MaloneScott Malone	Defender	 England
Photo for ZankaZanka	Defender	 Denmark
Photo for Abdelhamid SabiriAbdelhamid Sabiri	Midfielder	 Morocco
Photo for Florent HadergjonajFlorent Hadergjonaj	Defender	 Switzerland
Photo for Robert GreenRobert Green	Goalkeeper	 England
