Photo for Mohamed SalahMohamed Salah	Forward	 Egypt
Photo for Dominic SolankeDominic Solanke	Forward	 England
Photo for Loris KariusLoris Karius	Goalkeeper	 Germany
Photo for Simon MignoletSimon Mignolet	Goalkeeper	 Belgium
Photo for Danny WardDanny Ward	Goalkeeper	 Wales
Photo for Nathaniel ClyneNathaniel Clyne	Defender	 England
Photo for Dejan LovrenDejan Lovren	Defender	 Croatia
Photo for James MilnerJames Milner	Defender	 England
Photo for Joseph GomezJoseph Gomez	Defender	 England
Photo for Ragnar KlavanRagnar Klavan	Defender	 Estonia
Photo for Alberto MorenoAlberto Moreno	Defender	 Spain
Photo for Joel MatipJoel Matip	Defender	 Cameroon
Photo for Jon FlanaganJon Flanagan	Defender	 England
Photo for Trent Alexander-ArnoldTrent Alexander-Arnold	Defender	 England
Photo for Georginio WijnaldumGeorginio Wijnaldum	Midfielder	 Netherlands
Photo for Philippe CoutinhoPhilippe Coutinho	Midfielder	 Brazil
Photo for Jordan HendersonJordan Henderson	Midfielder	 England
Photo for Marko GrujicMarko Grujic	Midfielder	 Serbia
Photo for Sadio ManéSadio Mané	Midfielder	 Senegal
Photo for Adam LallanaAdam Lallana	Midfielder	 England
Photo for Emre CanEmre Can	Midfielder	 Germany
Photo for Lazar MarkovicLazar Markovic	Midfielder	 Serbia
Photo for Ovie EjariaOvie Ejaria	Midfielder	 England
Photo for Ben WoodburnBen Woodburn	Midfielder	 Wales
Photo for Harry WilsonHarry Wilson	Midfielder	 Wales
Photo for PaulinhoPaulinho	Midfielder	 Portugal
Photo for Roberto FirminoRoberto Firmino	Forward	 Brazil
Photo for Daniel SturridgeDaniel Sturridge	Forward	 England
Photo for Danny IngsDanny Ings	Forward	 England
Photo for Rhian BrewsterRhian Brewster	Forward	 England
Photo for Adam BogdanAdam Bogdan	Goalkeeper	 Hungary
Photo for Cameron BrannaganCameron Brannagan	Midfielder	 England
Photo for Andrew RobertsonAndrew Robertson	Defender	 Scotland
Photo for Alex Oxlade-ChamberlainAlex Oxlade-Chamberlain	Midfielder	 England