Photo for Victor LindelöfVictor Lindelöf	Defender	 Sweden
Photo for David de GeaDavid de Gea	Goalkeeper	 Spain
Photo for Sergio RomeroSergio Romero	Goalkeeper	 Argentina
Photo for Eric BaillyEric Bailly	Defender	 Cote D'Ivoire
Photo for Phil JonesPhil Jones	Defender	 England
Photo for Marcos RojoMarcos Rojo	Defender	 Argentina
Photo for Chris SmallingChris Smalling	Defender	 England
Photo for Daley BlindDaley Blind	Defender	 Netherlands
Photo for Luke ShawLuke Shaw	Defender	 England
Photo for Antonio ValenciaAntonio Valencia	Defender	 Ecuador
Photo for Demetri MitchellDemetri Mitchell	Defender	 England
Photo for Matteo DarmianMatteo Darmian	Defender	 Italy
Photo for Paul PogbaPaul Pogba	Midfielder	 France
Photo for Juan MataJuan Mata	Midfielder	 Spain
Photo for Jesse LingardJesse Lingard	Midfielder	 England
Photo for Michael CarrickMichael Carrick	Midfielder	 England
Photo for Ashley YoungAshley Young	Midfielder	 England
Photo for Ander HerreraAnder Herrera	Midfielder	 Spain
Photo for Henrikh MkhitaryanHenrikh Mkhitaryan	Midfielder	 Armenia
Photo for Marouane FellainiMarouane Fellaini	Midfielder	 Belgium
Photo for Anthony MartialAnthony Martial	Forward	 France
Photo for Marcus RashfordMarcus Rashford	Forward	 England
Photo for Romelu LukakuRomelu Lukaku	Forward	 Belgium
Photo for Nemanja MaticNemanja Matic	Midfielder	 Serbia
Photo for Zlatan IbrahimovicZlatan Ibrahimovic	Forward	 Sweden
Photo for Joel PereiraJoel Pereira	Goalkeeper	 Portugal
Photo for Scott McTominayScott McTominay	Midfielder	 England
Photo for Axel TuanzebeAxel Tuanzebe	Defender	 England