Photo for Darren FletcherDarren Fletcher	Midfielder	 Scotland
Photo for Jack ButlandJack Butland	Goalkeeper	 England
Photo for Jakob HaugaardJakob Haugaard	Goalkeeper	 Denmark
Photo for Lee GrantLee Grant	Goalkeeper	 England
Photo for Erik PietersErik Pieters	Defender	 Netherlands
Photo for Glen JohnsonGlen Johnson	Defender	 England
Photo for Ryan ShawcrossRyan Shawcross	Defender	 England
Photo for Geoff CameronGeoff Cameron	Defender	 United States
Photo for Thomas EdwardsThomas Edwards	Defender	 England
Photo for Joe AllenJoe Allen	Midfielder	 Wales
Photo for Stephen IrelandStephen Ireland	Midfielder	 Ireland
Photo for Ibrahim AfellayIbrahim Afellay	Midfielder	 Netherlands
Photo for Charlie AdamCharlie Adam	Midfielder	 Scotland
Photo for Xherdan ShaqiriXherdan Shaqiri	Midfielder	 Switzerland
Photo for Ramadan SobhiRamadan Sobhi	Midfielder	 Egypt
Photo for Saido BerahinoSaido Berahino	Forward	 England
Photo for Mame Biram DioufMame Biram Diouf	Midfielder	 Senegal
Photo for Peter CrouchPeter Crouch	Forward	 England
Photo for Julien NgoyJulien Ngoy	Forward	 Belgium
Photo for Thibaud VerlindenThibaud Verlinden	Forward	 Belgium
Photo for Josh TymonJosh Tymon	Defender	 England
Photo for Oliver ShentonOliver Shenton	Midfielder	 England
Photo for Kurt ZoumaKurt Zouma	Defender	 France
Photo for Harry SouttarHarry Souttar	Defender	 Scotland
Photo for Eric Maxim Choupo-MotingEric Maxim Choupo-Moting	Midfielder	 Cameroon
Photo for Bruno Martins IndiBruno Martins Indi	Defender	 Netherlands
Photo for JeséJesé	Forward	 Spain
Photo for Kevin WimmerKevin Wimmer	Defender	 Austria
Photo for Harry SouttarHarry Souttar	Defender	 Scotland