Photo for Erwin MulderErwin Mulder	Goalkeeper	 Netherlands
Photo for Lukasz FabianskiLukasz Fabianski	Goalkeeper	 Poland
Photo for Kristoffer NordfeldtKristoffer Nordfeldt	Goalkeeper	 Sweden
Photo for Mike van der HoornMike van der Hoorn	Defender	 Netherlands
Photo for Alfie MawsonAlfie Mawson	Defender	 England
Photo for Martin OlssonMartin Olsson	Defender	 Sweden
Photo for Angel RangelAngel Rangel	Defender	 Spain
Photo for Kyle NaughtonKyle Naughton	Defender	 England
Photo for Kyle BartleyKyle Bartley	Defender	 England
Photo for Federico FernándezFederico Fernández	Defender	 Argentina
Photo for Ki Sung-yuengKi Sung-yueng	Midfielder	 South Korea
Photo for Leon BrittonLeon Britton	Midfielder	 England
Photo for Leroy FerLeroy Fer	Midfielder	 Netherlands
Photo for Nathan DyerNathan Dyer	Midfielder	 England
Photo for Wayne RoutledgeWayne Routledge	Midfielder	 England
Photo for Luciano NarsinghLuciano Narsingh	Midfielder	 Netherlands
Photo for Tom CarrollTom Carroll	Midfielder	 England
Photo for Jay FultonJay Fulton	Midfielder	 Scotland
Photo for Jordan AyewJordan Ayew	Forward	 Ghana
Photo for Tammy AbrahamTammy Abraham	Forward	 England
Photo for Roque MesaRoque Mesa	Midfielder	 Spain
Photo for Sam ClucasSam Clucas	Midfielder	 England
Photo for Courtney Baker-RichardsonCourtney Baker-Richardson	Forward	 England
Photo for Renato SanchesRenato Sanches	Midfielder	 Portugal
Photo for Wilfried BonyWilfried Bony	Forward	 Cote D'Ivoire
Photo for Adam KingAdam King	Midfielder	 Scotland
Photo for Oliver McBurnieOliver McBurnie	Forward	 Scotland
Photo for Joe RodonJoe Rodon	Defender	 Wales
Photo for Brandon CooperBrandon Cooper	Defender	 Wales