Photo for Hugo LlorisHugo Lloris	Goalkeeper	 France
Photo for Michel VormMichel Vorm	Goalkeeper	 Netherlands
Photo for Danny RoseDanny Rose	Defender	 England
Photo for Toby AlderweireldToby Alderweireld	Defender	 Belgium
Photo for Jan VertonghenJan Vertonghen	Defender	 Belgium
Photo for Kieran TrippierKieran Trippier	Defender	 England
Photo for Ben DaviesBen Davies	Defender	 Wales
Photo for Kyle Walker-PetersKyle Walker-Peters	Defender	 England
Photo for Son Heung-MinSon Heung-Min	Midfielder	 South Korea
Photo for Erik LamelaErik Lamela	Midfielder	 Argentina
Photo for Victor WanyamaVictor Wanyama	Midfielder	 Kenya
Photo for Georges-Kévin NkoudouGeorges-Kévin Nkoudou	Midfielder	 France
Photo for Eric DierEric Dier	Midfielder	 England
Photo for Moussa SissokoMoussa Sissoko	Midfielder	 France
Photo for Mousa DembéléMousa Dembélé	Midfielder	 Belgium
Photo for Dele AlliDele Alli	Midfielder	 England
Photo for Christian EriksenChristian Eriksen	Midfielder	 Denmark
Photo for Harry WinksHarry Winks	Midfielder	 England
Photo for Harry KaneHarry Kane	Forward	 England
Photo for Davinson SánchezDavinson Sánchez	Defender	 Colombia
Photo for Paulo GazzanigaPaulo Gazzaniga	Goalkeeper	 Argentina
Photo for Juan FoythJuan Foyth	Defender	 Argentina
Photo for Serge AurierSerge Aurier	Defender	 Cote D'Ivoire
Photo for Fernando LlorenteFernando Llorente	Forward	 Spain
Photo for Anthony GeorgiouAnthony Georgiou	Midfielder	 England
Photo for Tashan Oakley-BootheTashan Oakley-Boothe	Midfielder	 England
Photo for Alfie WhitemanAlfie Whiteman	Goalkeeper	 England
Photo for Luke AmosLuke Amos	Midfielder	 England
Photo for Kazaiah SterlingKazaiah Sterling	Forward	 England