Photo for Jay RodriguezJay Rodriguez	Forward	 England
Photo for Ben FosterBen Foster	Goalkeeper	 England
Photo for Boaz MyhillBoaz Myhill	Goalkeeper	 Wales
Photo for Alex PalmerAlex Palmer	Goalkeeper	 England
Photo for Allan NyomAllan Nyom	Defender	 Cameroon
Photo for Jonny EvansJonny Evans	Defender	 Northern Ireland
Photo for Gareth McAuleyGareth McAuley	Defender	 Northern Ireland
Photo for Craig DawsonCraig Dawson	Defender	 England
Photo for Claudio YacobClaudio Yacob	Midfielder	 Argentina
Photo for James MorrisonJames Morrison	Midfielder	 Scotland
Photo for Jake LivermoreJake Livermore	Midfielder	 England
Photo for Matt PhillipsMatt Phillips	Midfielder	 Scotland
Photo for Chris BruntChris Brunt	Midfielder	 Northern Ireland
Photo for James McCleanJames McClean	Midfielder	 Ireland
Photo for Nacer ChadliNacer Chadli	Midfielder	 Belgium
Photo for Hal Robson-KanuHal Robson-Kanu	Forward	 Wales
Photo for Salomón RondónSalomón Rondón	Forward	 Venezuela
Photo for Ahmed HegaziAhmed Hegazi	Defender	 Egypt
Photo for Max MelbourneMax Melbourne	Defender	 England
Photo for Gareth BarryGareth Barry	Midfielder	 England
Photo for Oliver BurkeOliver Burke	Midfielder	 Scotland
Photo for Kieran GibbsKieran Gibbs	Defender	 England
Photo for Grzegorz KrychowiakGrzegorz Krychowiak	Midfielder	 Poland
Photo for Sam FieldSam Field	Midfielder	 England
Photo for Rayhaan TullochRayhaan Tulloch	Forward	 England
Photo for Nathan FergusonNathan Ferguson	Defender	 England