Photo for Pablo ZabaletaPablo Zabaleta	Defender	 Argentina
Photo for AdriánAdrián	Goalkeeper	 Spain
Photo for Winston ReidWinston Reid	Defender	 New Zealand
Photo for Aaron CresswellAaron Cresswell	Defender	 England
Photo for James CollinsJames Collins	Defender	 Wales
Photo for Angelo OgbonnaAngelo Ogbonna	Defender	 Italy
Photo for Sam ByramSam Byram	Defender	 England
Photo for José FonteJosé Fonte	Defender	 Portugal
Photo for Arthur MasuakuArthur Masuaku	Defender	 Congo
Photo for Cheikhou KouyatéCheikhou Kouyaté	Midfielder	 Senegal
Photo for Manuel LanziniManuel Lanzini	Midfielder	 Argentina
Photo for Pedro ObiangPedro Obiang	Midfielder	 Spain
Photo for Mark NobleMark Noble	Midfielder	 England
Photo for Michail AntonioMichail Antonio	Midfielder	 England
Photo for Edimilson FernandesEdimilson Fernandes	Midfielder	 Switzerland
Photo for Andy CarrollAndy Carroll	Forward	 England
Photo for Diafra SakhoDiafra Sakho	Forward	 Senegal
Photo for André AyewAndré Ayew	Forward	 Ghana
Photo for Joe HartJoe Hart	Goalkeeper	 England
Photo for Marko ArnautovicMarko Arnautovic	Forward	 Austria
Photo for ChicharitoChicharito	Forward	 Mexico
Photo for Sead HaksabanovicSead Haksabanovic	Midfielder	 Montenegro
Photo for Nathan TrottNathan Trott	Goalkeeper	 England
Photo for Nathan HollandNathan Holland	Midfielder	 England
Photo for Domingos QuinaDomingos Quina	Midfielder	 Portugal
Photo for Declan RiceDeclan Rice	Midfielder	 Ireland
Photo for Antonio MartínezAntonio Martínez	Forward	 Spain
Photo for Ben JohnsonBen Johnson	Midfielder	 England
Photo for Moses MakasiMoses Makasi	Midfielder	 England